12 6
10.5 3
-1 0
1 1 1
1 1 1
1 1 1
1 1 1
1 1 1
1 1 1
1 1 1
1 1 1
1 1 1
1 1 1
1 1 1
1 1 1
1 1 1
1 0 1
1 0 1
1 0 1
1 0 1
1 0 1
1 0 1
1 0 1
1 0 1
1 0 1
1 0 1
1 1 1
1 1 1
1 0 1
6 0 1
6 0 1
6 0 1
6 0 1
6 0 1
6 0 1
6 0 1
6 0 1
6 0 1
6 1 1
1 1 1
1 0 1
6 0 1
6 0 1
6 0 1
6 0 1
6 0 1
6 0 1
6 0 1
6 0 1
6 0 1
6 1 1
1 1 1
1 0 1
1 0 1
1 0 1
1 0 1
1 0 1
1 0 1
1 0 1
1 0 1
1 0 1
1 0 1
1 1 1
1 1 1
1 1 1
1 1 1
1 1 1
1 1 1
1 1 1
1 1 1
1 1 1
1 1 1
1 1 1
1 1 1
1 1 1
3 3 3 3
10.5 3 1 1 2 2 1
3 3 2 2 255 255 0 100
3 2 5
3 4 5
6 2 5
6 4 5
9 4 5
9 2 5